[level]
tileset = tileset.png
cells = ........................
        .............##.#####...
        ................#.......
        ........####.#....######
        .##..........##.........
        .....####....##.........
        .##..........##.........
        .....####...............
        .......#.........####...
        ...######......######...
        ...............######...
        .####.######...######...
        .....####...............
        .....####...............
        .....####...............
        .......#.........####...
        .................####...
        .....####...............
        .....####...............
        .....####....##.........
        ........................
        .....####...............
        .................####...
        .......#.........####...

[.]
name = floor
tileset_pos = 1, 0
walkable = true

[#]
name = grass
tileset_pos = 2, 1
walkable = false