[level]
tileset = tileset.png
tiles = ....G..GGGGGGGG.
        ..GGGGGG..TTGTTG
        G.....G......T..
        GG...TTTTGTG...T
        G....G...GTT...G
        .G.TTTG..GT.G...
        G...G.GG..G.....
        G..TTT....G.G...
        ....GG..GTTTTG..
        T..T..GGTTGGTG..
        GG....GGGGGTTG..
        GTTTG.GTTTTTTG..
        GG.G....GGGGG...
        .G.....GGG.....G
        TG..G...G..G...G
        G.G...G..TTTT...

[.]
name = floor
tileset_id = 3
walkable = true

[G]
name = grass
tileset_id = 10
walkable = true

[T]
name = tree
tileset_id = 14
walkable = false